11111111111111111110
10000000000000000001
1110P0C0000000000001
11110111111111111111
10000000000000000000
10000000000000000E01
111000C0000000000001
11111101111111111111
111000C0000000000001
11111101111111111111
11100000000000000000
11111111111111111110