111111111111111111111111111111111111111111111111111111111111111
100000000000000000000000000000000000000000000000000000000000001
100000000000000000000000000000000000000000000000000000000000001
100C000000000000000000000000000C0000000000000000000000000000001
100000000000000000000000000000000000000000000000000000000000001
100000000000000C00000000000000000000000000000000000000000000001
100000000000000000000000000000000000000000000000000000000000001
100000000000000000000000000000000000000000000000000000000000001
100000000000000000000000000000000000000000000000000000000000001
100000000000000000000000000011110000000000001111110000000000001
100000000100001000000000001111000011111111110001110000000000001
100000011100001100010010111111111111000000000000000000000000001
10000111110000011110111111100000000000111111111000000000000E001
100001110001100001111111111011111111111111111111100000000000001
100P0111101111000111111C000001111111111111111111111111111000001
111111111111111111111111111111111111111111111111111111111111111