1111111111111111111111111111111111111111111111111111111111
11000000111111111111000000001111111111110000000011110CC111
10010000000000000000000000000000011110000000000000100CC011
1C01101100000000000000000000000000000000000000000000000001
1001101100000000000011111000000000000000000000000000000001
1111001110000000111111111100000000000000000000000000000001
111C011110000000000000011100000000000000000000000000000001
1111111000000111100000000000000000000010000000111111000001
10C00000000111111011111101111100000011110000011110E0000001
1111000001111111101111110111111111111111111111111111110001
100000011111100000111111C111111111000000000000000001111101
1100P0011C00000011111111111100000000C11111111000CCC1111101
111000111111110000000000C000011111111111111111110CC1111001
1111111111111111111111111111111111111111111111111111111111