
11111111
1C1C0111
1P0000E1
11111111