111111111
11C1C0111
11P0000E1
111111111