11111
1CPE1
111111 bug this shouldn't happen
