111111111111111111
100000000000000001
100000000000000001
1CC000000000000111
1PC00000C0000001E1
111111111111111111
