111111111111111111
100000000000000001
00000000000000000000111
100000000000000000010
100000000000000001
1P0C00000000E1
11111111111111
1111
1