111111111111111111111111
100000000000000000000111
100000000000000000001011
1CC000000000000111111111
1PC00000C0000000E0000001
111111111111111111111111
