111111111111111111111111
101011000001E001111110C1
1010C1000001000000001001
101001000001111111001001
100000011000000000001101
100001111001111111100001
1P00C00C1001C00000000001
111111111111111111111111