111111111111111111111111111111111111111111
1110000000000111111C11111011111111C0000111
111C111C0111000000000000000000011111110111
1111111101011111011011101111110000C0000111
111000000101110101100110000000111101111111
111111010101111100110111111110111101111111
111000010C0000011000000001111011110C111111
111111011111000111011110000000C10111111111
100011011111111110001000000011111101111111
10P00000000000000000000000000000000001E001
111111111111111111111111111111111111111111
