1111111111111111
10000000000000000001
1110P0C0000000000E01
11111111111111111111