111111111111111111
100000000000000001
000000000000000111
100000000000000010
100000000000000001
1P0C00000000E10001
111111111111111111
111111111111111111
111111111111111111