111111
100001
100001
1PC0E1
111111
