1111111
1000001
1000001
1000001
1000001
1P0CE01
1111111